1111111111111
1C00001C100C1
1011101000001
1110101011101
1P0000000C1E1
1111111111111