1111111111
1000000001
1111101101
1000000001
1011111111
10000P00E1
1111111101
1000000001
1011111111
100000C001
1111111111