11111111111111111111111111111111111111111111111111
10000000000000000000000100000000000000000000000101
10000000000000001111111011111111100000000000000011
10000000000000010000000000000001000000000000000001
10000000000000011111111111111111000000000000000001
10000000000000000000000000000000000000000000000001
10000000000000000000000000000000000000000000000001
10000000000000000000000000000000000000000000000001
10000000000000000000000000000000000000000000000001
100000000000000000000000000X0000000000000000000001
10000000000000000000000000000000000000000000000001
100C0010000000000000000000000000000000000000000001
10101010000000000000000000000000000000000000000001
10000010000000000000000000000000000000000000000001
10101010000000000000000000000000000000000000000001
10000010000000000000000000000000000000000000000001
11111111011111111011111111011111111011111111000001
10000011010000011010000001010000001010000001000001
11111011011111011011111101011111001011111111000001
11111011011111011010000101011111001011111001000001
10000000010000000010000101000000001000000001000001
10111111110111111110111101011111101011111101000001
10CC0000E00CC0000010011100100000000100000001000001
11111111011111111011111001011111001011111001000001
10000P00010000000010000001011111001011111101000001
10111111110111111111111111011111001011111001000001
10000000010000000000000000011111000000000001000001
11111111111111111111111111111111111111111111111111
