1111111111111111111
1000000000000000001
1000000000000000001
1000000000000000001
1000000000000000001
1000000000000000001
1000000000000000001
1000000000000000001
1000000000000000001
1111111000000000001
1000001000000000001
1010101000000000001
1000001000000000001
1010101000000000001
1000001000000000001
1111111101111111101
1000001101000001101
1111101101111101101
1111101101111101101
1000000001000000001
1011111111011111111
10CC0000E10CC000001
1111111101111111101
10000P0001000000001
1011111111011111111
1000000001000000001
1111111111111111111